8 клас
1a
athlete - спортсмен ка

deadline - граничний строк виконання


except - окрім

instructions in strak Jana - інструкцій

musician - музикант ка

remind - нагадувати

term time - термін навчання

tutor - репетитор ка наставник ця


Types of schools


boarding school - школа інтернат

homeschooling - домашне навчання

music school - музична школа

sports school - спортивна школа


School facilities


drama room - кабінет театрального


first aid room - кабінет надання


head teacher s office - кабінет


music room - кабінет музики


Phrases


What are you up to - Що ти робиш


Why not - Чому б і ні


1b


 let let - дозволяти

nervous - нервуватися хвилюватися

pretty adv Sounds - достатньо досить

pretty boring - Звучить досить нудно

search - шукати

stamp - марка

stuff - такі речі

title - назва

turn - чиясь черга


Words/Phrases related to education


break time - час перерви перерва

do well in a testschool - добре скласти




get good - погану


get results - отримати результат

miss a test - заняття


pass a test - скласти іспит



sit for an exam - складати тест іспит


Phrases


Beats m - е Я не знаю

Come again - Повтори ще раз

give stha o - дпробувати

I guess not - Думаю що ні

I have to run - Мушу бігти

Sort of - Щось схоже Нібито Як відповідь на


What for - Для чого?


1c


advantage - перевага

anxious - тривожний

communicate chin - куватися

concentrate - концентруватися


connect - підключитися підєднатися до

constantly - постійно весь час

control V - контролювати перевіряти

challenge n - виклин

digital - цифровий

disconnect - відключити відєднати

electronic device - електронний


every now and then - інколи час від часу

experience v - відчути спробувати


head teacher - директор ка школи

imagine - унвити

keep continue doing sth - продовжувати


last V - продовжуватися тривати

notification - повідомлення

performance - успішність

pocket - кишеня

realise - усвідомлювати

send send - відправити надіслати

skills - вміння

smartphone - смартфон

social - соціальний

social media - соціальні мережі

survey - дослідження

take part - брати участь

though - хоча

turn off - вимикати

while n - деякий час


Words/Prases related to technology


connect to the internet - підключатися до інтернету

download music apps videos - завантажувати


make a phone - зателефонувати здійснити відеодзвінок


emails - надсилати голосові повідомлення електронні листи


1d


 a great number of - багато велика кількість

be informed - бути в курсі

business - бізнес справа

definition - визначення

for instance - наприклад


international - міжнародний

non native - нерідний немісцевий

panic - паніка панікувати

population - населення

take care of - турбуватися про когось


throughout tru aot - впродовж протягом

topic - тема для обговорення

web page - вебсторінка


Phrasal verds


come across - натрапити на зустріти


come round - зайти в гості завітати

come up with - придумувати


look after - доглядати за кимось


look forward to - з нетерпінням


look out - бути обережним ою

look up - подивитися пошукати


1e


e be over - закінчитися

celebration - святкувати

collection - колекція

create Ari est - створювати винаходити

especially - особливо

fire alarm - пожежна сигналізація


in fact in f kt - фактично насправді

model car modal kar - модель автомобіля

react p - еагувати

uniform n - форма шкільна

reply n plas - відповідь


2_TEEN_LIFE
2a


a abitabit - трохи


atmosphere - атмосфера

bossy - владний той хто любить


fall asleep - засинати


get along with - ладнати з

give up stop trying - здатися

immediately - негайно

popcorn - попкорн

showing - показник

that - що так тобто

upload a video - завантажити відео

variety - розмаїття


vlogger - влогер ка

queue up y - ставати в чергу


Places


bowling alley - Боулінг доріжка для


concert - концерт


theme park - тематичний парк, парк атракціонів 


Phrases


Got it - Зрозумів Зрозуміла Ясно

Hang in there - Не здавайся


Here we go again - Ну ось знову

I know the feeling - Мені знайоме це відчуття

What are you waiting for - Чого ж ви чекаєте

What`s he - який він (вона)


2b 


b already - вже

appointment - зустріч

as soon as jaz sun az - к тільки

gladoled - радий

hairstyle - зачіска

in fashion - у моді

keep - тримати

make up one s mind - визначитися з вибором

out of fashion - не в моді

pretty adj - гарненький гарненька

regret - жалкувати

stand out - виділятися

suit V n - асувати підходити

tie V san - язувати

totally - повністю цілком


Words related to hairstyling


buzz cut - стрижка під каре

dreadlocks - дреди зачіска

dye V - фарбувати волосся

dyed hair - пофарбоване волосся

extensions - збільшення нарощування

highlights - мелірування волосся

perm n - хімічна завивка

permed hair - хімічна завивка волосся

ponytail - хвостик зачіска

trim n - підстрижене волосся стрижка

wig - перука


Phrases


Are you kidding - Жартуєш

Are you serious - Ти серйозно

Forget it - Забудь про це


You know what - Знаеш що

Youre right therejor rast dear - Ти тут Ти прямо


2c


brand - марка бренд

casual - повсякденний одяг

collection related to fashion - колекція

design n - дизайн

designer - дизайнер ка

fit - підходити за розміром або дизайном

formal - формальний офіційний

graffiti - графіті

introduce - представити

not say a word - ні слова не сказати

notice V - помічати

product - продукт

style - стиль


Design Patterns


baggy - мішкуватий

checked - у клітинку картатий

flared - розкльошені

sparkly - блискучий

spotted - плямистий

striped - смугастий у смужку

tight - тісний


Materials


cotton - Бавовняний

denim - джинсовий

leather - шкіряний

silk - шовковий

woollen - шерстяний


2d


act - поводитися діяти

adult - дорослий а

become - ставати

chapter - розділ

connection - за каки

danger - небезпека

develop - розвивати розвиватися

disappear - зникати

exist to st - нувати

go on happen - продовжуватися

grow up - подорослішати

have trouble doing sth - мати проблеми з


keep in mind - памятати

make sbdifferent etc - робити когось щось особливим іншим тощо

memory - память

need n - потребувати

pay attentionsaep - тати увагу

period - період

recognise - впізнати

route - маршрут

speed n - швидкість

strength - сила


way direction - шлик

weak - слабкий

wonder V - цікавитися


2e


e annoy - дратувати

argue - сперечатися

change one s mind - передумати

cheer sb up - підбадьорювати когось

dance move - танцювальний рух

dislike - неприязнь те що не подобається

fight V - битися

friendship - дружба


make a decision - прийняти


rely on r las on - покладатися на

risky - ризиковано

sense of humour - почуття


shout at sb - кричати на когось

teach - навчати

turn to - звернутися до


Adjectives describing personality


annoying - дратівливий

confident - впевнений у собі

easy going - легкий на підйом

kind - добрий

outgoing - комунікабельна людина

quick tempered - запальний

stubborn - впертий


3_MY_LIFESTYLE
3a


a against a genst - проти

beat v - перемогти лобити когось в чомусь

book V - замовити забронювати


exhibition - виставка

hit V hat - бити вдаряти


make plans - планувати

net - сітка

point n - бал

match point - матч пойнт


Experiences


do a cookery course - проходити кулінарний курс

go to a sports centre - художню галерею

join a club - команди

learn a languag - е вивчити мову

meet someone - пеш познайомитися з кимось новим

try a new dish - спробувати нову страву

watch a live performance - подивитися телесеріал


Phrases


Count me in - Я з вами

Go ahead - Давай

Hurray! - ура!

Serve! - подавайте!


3b



culture - культура

diary - щоденних

disappointed - розчарований

drop v - апустити

grill V - тувати на грилі

ground - земля

have sth in com - топ мати щось спільне

improve - покращувати

instead of on sted av - замість того щоб

keep sb busy - зайняти когось

lift V - підіймати

meaning - значення

prepare - готувати


stunt n - трюк

unforgettable - незабутній

welcome - ласкаво просимо


Phrasal verbs


pick sb up collect sb - забрати когось

pick sb - підняти когось на руки


put sth n - оодягнути

take off - злітати про літак

take sth off - знімати про одяг


3c


combine - поєднувати

comment - коментар коментувати

creativity - креативність

drawing tablet - планшет для


express V - виражати

follower - прихильник ця підписник ци

one of a kind - неповторний


post v - публікувати робити допис

relative n - родич ка

responsible in spon sa bal - відповідальний

script - сценарій

work n - робота


Hobbies


have a dance lesson - мати заняття з танців

make a video c - творювати відео

play a musical instrument - грати на музичному Інструменті

write a poem - написати вірш чи історію


3d


!Проблема!

accommodation ja koma des Jan - проживання

all year round - цілий рік

available a ver la bal - доступний наявний

astronaut - астронавт

break - перерва канікули



extra - додатковий

housing - житло

include an klud - містить у собі

definitely - безумовно

have a word with sb - поговорити з ким небудь

let sb down - підвести когось

possible - можливий

rehearse - репетирувати

support - підтримувати

venue - місце локація проведення заходу


be in one s way s - аважати комусь стояти на чиемусь шляху

be on one s way - бути в дорозі

by the way - до речі

know one s way around - орієнтуватися на місцевості

lose one s way - збитися зі шляху загубитися

the other way round - навлаки


Get out of here - Забирайся звідси

I reckon - Вважаю


Yep - Так

You can say that again - Можеш повторити

!Проблема!


4c



best selling - бестселер

career - карера

compose - писати музичний твір

composer - композитор ка

conductor - диригент ка

copy n - копія

degree - ступінь

folk adj - народний

full time - повний робочий день

lyrics - текст опери чи пісні




release V - випускати альбом

serve - подавати страви

split up - розділятися

worldwide - по всьому світу


Words/phrases relating to the music industry


album - альбом

contract n - контракт

demo - демо версія музичного твору

fans - шанувальники

go on tour - їхати на гастролі в тур

musician - музикант ка

music video - деокліп

producer - продюсер ка

record V - записувати

sign v - підписувати ставити підпис

talent - талант


4d




be part of - бути частиною

behave - поводитися

concertgoer - відвідувач ка концертів

highlight n - найяскравіший момент

live one s dream - жити своєю мрією

own adj - власний

performer - виконавець иця

pull V n - ягнути

separate v - відокремлювати

show n - шоу показ

value for money - співвідношення ціни і якості


Expressions with come


come a long way - пройти довгий шлях

come alive - оживати

come as a surprise - стати несподіванкою

come in handy c - тати в пригоді знадобитися

come to an end - завершуватися

come to think of it - якщо подумати то спасти на


come true - здійснитися


4e



cheer v - голосно вигукувати заохочувальні


clap - плескати аплодувати

entertaining possa - жальний

excitement - захоплення


hope - сподіватися

interaction - взаємодія

live - живий

lively lervli - авий

musical n - музичний

overall adv - го загальний

participation - участь

restless - неспокійний невгамовний

sociable - товариський

stage - сцена


Idioms


a pain in the neck - ми кістка в горлі

be blown away - бути дуже враженим ок чимось

be bored out of one s mind - бути надзвичайно


be over the mo - оп бути на сьомому небі від щастя

be thrilled to bits - бути схвильованим ою до нестями

be - почуватися на вершині світу

drive sb up the wall - розсердити когось дратувати когось

drive sb wild p - азлютити когось

get a kick out of sth - отримувати задоволення від чогось

get on one s nerves - нервувати когось

give sb a warm welcome - влаштовувати теплий прийом для кагось

have a whale of a time - гарно провести час

make one s day - зробити чийсь день кращим


5_READING_FOR_PLEASURE
5a


a among prep - а то серед

angrity - сердито

approach v ja praot - наближатися до

archer - лучник ця

archery - стрільба з лука

arrest V - заарештувати

arrow - стріла

bow n - лук

catch V - ловити

centre - центр

feather - перо

gather - збирати

grass - трава

hard adj - важкий

hold - проводити захід

hut - хатина курінь

law - зако


messenger - посланець иця

pass V - проходити повз

shoot just - стріляти

shot n fot - вистріл

slice - зрізати

target - мішень

unfair - несправедливий


5b


anger - гнів

certain adj - певний

chain n - ланцюг

corridor - коридор

drawer n - шухляда

face to - віч на віч

fill v sa - повнювати

frighten - лякати

ghost n - привид

gun - пісталет

haunted - заселений привидами

insult V - ображати

move into a place - переїхати в


mysterious - таємничий

old fashioned - старомодний

once again - ще раз

otherwise - інакше в іншому разі

past adv - минулий

peaceful - мирний


reach V - досягати

reappear - зявлятися знову

secret adj - таємний

skeleton - скелет

slipper - домашни туфля кімнатний


smash v - розбивати

stain n - пляма

take revenge - помститися


the rest pe - шта

treat V - обходитися поводитися

twin - двійня

warm - застерігати


5c


author - автор

biography - Біографія

book fair - книжковий ярмарок

book presentation - презентація


classic - класика


cookbook - кулінарна книга

crime - кримінал

graphic novel - графічний роман

fiction - фантастика

history book - історична книга

non fiction - нехудожня література


novel n - роман

pancakes - млинці

present n - подарунок

science fiction - наукова фантастика

travel n - подорож

workshop - майстерня


5d


a big reader - великий а любитель ка читання

a book hard to put down - книга яку важко відкласти

a must - обовязковий те що повинно бути обовязково

adore - обожнювати

autobiography taubat ografi - втобіографія

blurb - анотація книжки

celebrity - знаменитість

comedian - комік иня


cover - обкладинка

criminal kroman - злочинець иця

description - опис

editor - редактор ка

educate - навчати виховувати

era - епоха ера

get sb thinking - змусити



hardly anybody - майже ніхто

historian - історик иня

light material - лепкий матеріал

literature - література

made up - вигаданий

make one s way back - повернутися назад повертатися

operation - операція


profession - професія

run out of ran aut ov - закінчуватися

society - суспільство

spare time - вільний час

surgeon - хірург имя

survive - виживати

technology i - техналогя


thief - злодій ка

through the ages - крізь віки

young at heart - молодий душею


5e


attic - горище

curious - допитливий

discover - відкривати

entery - війти

forever - назавжди

located - розташований

lock - амок

nervously - нервово

pick sth up - брати що небудь в руки

puton - одягнути покласти на

rope - мотузка

take a look - поглянути

touch - торкатися

treasure chest - скриня грудка


upside down - догори дритом


Adjectives ending in -ed and -ing


amazed - здивуватися

amazing - дивовижний

amused - забавний

amusing - кумедний смішний

astonished - здивований

astonishing - приголомшливо

satisfied - задоволений

satisfying - який задовольняе

terrified - переляканий

terrifying - жахливий жахливо

thrilled - схвильований

thrilling - хвилюючий


Phrases


!Проблема!

All of a sudden - Зненацька


I couldn t believe my eyes - Я не міг могла


Luckily - На щастя

My heart jumped - Моє серце підстрибнуло


To my surprise - На мій подив

!Проблема!




6_TECHNOLOGY_AND_MEDIA
6A


be in a hurry - поспішати

catch the bus - встигнути на автобус

collect sth from somewhere - забрати щось звідкись

download - завантажувати

gigabyte GB ri - габайт

give sb a lift ni - двозити кого небудь підбадьорити

go for sth - їхати за чимось

plan V - планувати

Wi Fi Wi - Вай Фай


Telephone languagе


be engaged - бути залученим


call back - передзвонити

dial - набирати номер



hang up - покласти слухавку

have a wrong number - помилитися номером

pick up - брати слухавку

return a call - передзвонити

taketesk liv a mesads - прийняти залишити повідомлення


6b



achievement - досягнення

argument - аргумент

communication - спілкування комунікація

cost V - коштувати

creation - створення

difference - різниця

digit - цифра цифровий

discuss - обговорювати

discussion - дискусія обговорення

emergency - надзвичайна ситуація



inform - інформувати


invention - винахід

invitation - запрошення

landline - стаціонарний телефон

mention - згадка

native language - рідна мова

organisation opravisa - ція

phrase - фраза

preparation - підготовка

punctuation mark - розділовий


useful - корисний

wire - дріт


6c


billion - мільярд

correct adj - правильний

get it rightget it rart ron - озуміти


get tired of - втомлюватися від

major adj - важливіший головний

non stop adj - безперервний

predict - передбачати

role n - раль

succeed - досягати успіху

try out - випробувати

TV setti viset - телевізор

worried about - турбуватися


Expressions with make 


make a decision - прийняти рішення

make a mistake s - робити помилку

make a phone call - зателефонувати

make a prediction - зробити прогноз

make money - заробляти гроші


6d



attach - прикріплювати файли

back up phr v - робити резервну ко

classmate - однокласник ця

contact v - контактувати

corner - куточок світу

debate n - обговорення дебати

enthusiastic o Ojunstik s - ахоплений

feature n - особливість

feedback - відгук

file n - файл

link n - посилання

loginlog in on - увійти в систему

log outlog sot of - вийти із системи

mind blowingsa - хопливий


native speaker - носій ка мови

newsfeed - рядок з новинами

participate - брати участь

password - пароль

platform - платформа

plug in - підключати підєднувати

private - приватний

scroll - прокручувати

set sth up - налаштовувати

shut down - вимикати

significant - значний

type in - ввести

username - імя користувача


6e


a waste of time - марна


back - спина

careless - недбалий

disadvantage - недолік


far away - далеко

helpless - безпорадний

unhealthy - нездоровий

useless - марний який не приносить


7_A_HELPING_HAND
7a


be worth - коштувати


brand new - новий

cleaner - чистіший

empty - порожній

filthy - дуже Брудний


hoover - пилосос

obvious - очевидний

owner - власник ця

property - як має бути належно

relationshipsp - стосунки взаємини

security guard - охоронець иця


Words related to crime


burglar - крадій

burglary - крадіжка зі зломом

inspector - інспектор ка

investigate - розслідувати

pickpocket - кишеньковий а злодій ка

pickpocketing - кишенькова


rob - грабувати

robber - грабіжник ця

robbery - пограбування

shoplifter - магазинний а злодій ка

shoplifting - крадіжка з магазину


steal - красти

theft - крадіжка


Phrases


Certainly - Звісно Звичайно Безумовно

No need He a - немає потреби. Не потрібно


7b



bedside table - тумбочка

bit n - невеликий шматок або кількість чогось

DIY do - обити


holie o - твір

push - штовхати

put sth together - зібрати щось

screw - гвинт закручувати

volume - обєм

wheel n - колесо


Phrasal verbs


turn down - зменшувати гучність

turn into neper - ворювати на

turn off - вимкнути

turn on ysi - мкнути

turn out - валяеться

turn over nepe - вернути

turn up - зробити гучніше збільшувати гучність


Phrases


Have a point Ma - еш рацію

I can t be bothered - Мені ліньки Не хочу турбуватися

I can t hear myself think - Я не чую своїх думок

lt`s a piece of cake - це дуже просто. Це найпростіше

lt`s supposed to be - це має бути

Whatever you say - Як скажеш


7c



balance - баланс

BF best friend - найкращий а друг подруга

blame V - звинувачувати

compete - змагатися

count on sb - розраховувати на когось

deal with ya - мати справ

excuse n - виправдовуватися

fault - провина

in need - потребувати

make an effort - докладати зусиль

make fun of - висміювати


prefer - віддавати перевагу

pretend - прикидатися

previous - попередній

ridiculous - безглуздо смішно

ripped - рваний

save - заощаджувати гроші

solution aluin - рішення

tablet - планшет

take the blame - брати провину на себе

the following - наступний

treat - купити для когось або


trouble - неприємність

walk all over sb - ставитися дуже погано до когось, бути недобрим та не поважати когось


Phrases


Keep it up - Продовжуйте в тому ж дусі

May the best player win - Нехай переможе найкращий а гравець гравчиня


7d


amaze - вражати

apart from - крім того що

border - кордон

care - турбота піклуватися турбуватися

charity - благодійність

donation - пожертвувания

extremely - надзвичайно

fundraising event I vent - Благодійний захід зі збору коштів

have a right - мати право


injury - травма

make a difference - змінити світ


patient n - паціент ка

raise money - збирати гроші

smile n - посмішка


treat care for - лікувати піклуватися

volunteer - волонтер ка

war - війна


7e


a variety of a va ratati ov pis - номанітність

advertise - рекламувати

advise - радити

bake sale - продаж випічки

bazaar - базар

collourful - барвистий різнокольоровий

fact - факт

for a good cause - для доброї справи

fundraiser - збір коштів фандрайзер



race V - перегони

tell a joke - розповісти анекдот жарт


Phrases


All you have to do is - Все що вам потрібно


Need any help - Потрібна допомога

Would you mind helping me out - Ви не могли б


8_HOLIDAYS
8A


active volcano - активний


enjoyable - приємний

experienced - досвідчений

get a tan - засмагати

globe - глобус

impress - вражати

interact - взаємодіяти

keen on - захоплюватися цікавитися

location - місце локація



marine life - морське життя

passion for - пристрасть до

relaxing - розслаблювальний

safety - безпека

scar - шрам

smart nice - розумний гарний

tie - краватка

whenever - коли б то не була


Types of holiday


backpacking holiday - відпочинок з рюкзаком

cruise - круїз

guided city tour - екскурсія


holiday by the seaside - відпочинок біля моря

safari - сафарі


8b


agritourism - агротуризм

bucket - відро

cowshed - корівник

mud - багнюка


pass - проходити пова


since - оскільки стому


spade - лопата

stable - стайни конюшни

steer clear - триматися подалі

take a break - зробити перерву

the outdoors not daz - на свіжому повітрі надворі назовні


Expressions with time


at all times at al tams - завжди постійно

from time to time - час від


give sb a hard time - завдавати


have time to kill - немає чим зайнитися протягом певного періоду часу мати


make time - знаходити час

take your time - не поспішати


Phrases
!Проблема!

The next thing I knew da nekat - Наступне що я памятаю

!Проблема!


8c


announcement o - голошення

break down - поломка

complaint - скарга

delay - затримка

delayed - із запізненням із затримкою


dissatisfied - незадоволений

hardly - ледве

impatient - нетерпимий дратівливий

impolite - неввічливий

impossible - неможливий

luxurious - розкішний

organised - організований

patient adj petint - терплячий

sail V - відпливати

service - обслуговування

shock - шок

tasteless - несмачний

uncomfortable - незручний

unpleasant - неприємний

unsuccessful - невдалий


Words/phrases related to traveling


board v - сідати на корабель

brochure - брошура

cabin - каюта


get sunburnt o - бгоріти на сонці

miss a flight - запізнитися на літак

on board - на борту

pack v - пакувати

passenger - пасажир ка

passport - паспорт

reception - приймальня рецепція

suitcase - валіза

travel agency - туристичне агентство



8d


blogger - Блогер ка

cheek - щока

common adj - звичайний


guest adj - гостьовий

custom - звичай

tap - торкнутися поплескати по плечу

tip advice - порада

tradition - традиція


Words/Phrase related to gestures


bow - кланятися


hug - обіймати

kiss - цілувати

point - показувати пальцем

shake hands - потиснути руки

wave - махати


Phrases


Good for you - Молодець


8e


assistance - допомога

beginner - початківець иця

choiceo - вибір

furthermore - крім того

hire - винаймати орендувати

in advance - заздалегідь

instructor - інструктор ка

minimum - мінімум

require - потребувати потрібно

resort - курорт

scenery - пейзаж


special offer - спеціальна пропозиція

unbelievable - неймовірний


Phrases related to formal letters


Dear Sir Mada - Шановний пане (пані)!

Yours faithfully - з повагою



Yours sincerely - з повагою




